


R 10 10
F 255,204,196
F 255,204,196
NO textures/bluestone.xpm
SO		textures/wood.xpm
C 0,150 , 	200
EA./textures/eagle.xpm
WE./textures/wall_4.xpm
S	./textures/sprite_2.xpm

         111
         121
         1111
         121
         121
111111111101111
10002000200021
10200020002002111111111
11111000002220000000001 111
    1000211120011111111
    1000211120011
    1000022200011111111
    1111111111000112110111111111111
    11212100000021020020111111111
    1020200202020201111111
    1020200202120111111111111
    1111111110002200000000011
     1200000020000000111000001      111
     100002222000000000222200111111111111
     1100200000100002000200002020202020201
     1000000001101110001010011111111110201
     1100200000000110000200000011111110201
     1001000001101111210001001111111110201
     1111111111101111111111111111111110201
               101                  10201
               101                  10201
               101                  10201
               101111111111111111111110201
               100022222222222222220000001
               101111111111111111111111111
               1221
              1221
             1221
            1221
           1221
          1221
         1221
        1221
       1S21
       121
       1201
      1021
       1201
      1021
       1201
      1021
       1201
      1021
       1201
      1021
       1201
      1021
       1201
      1021
       1201
      1021
       1201
      1021
       1201
      1021
       1201
      1021
       1201
      1021
       1201
      1021
       1201
      1021
       1201
      1021
       1201
      1021
       1201
      1021
       1201
      1021
       1201
      1021
       1201
      1021
       1201
      1021
       1201
      1021
       1201
      1021
       1201
      1021
       1201
      1021
       1201
      1021
       1201
      1021
       1201
      1021
       1201
      1021
       1201
      1021
       1201
      1021
       1201
      1021
       1201
      1021
       1201
      1021
       1201
      1021
       1201
      1021
       1201
      1021
       1201
      1021
       1201
      1021
       1201
      1021
       1201
      1021
       1201
      1021
       1201
      1021
       1201
      1021
       1201
      1021
       1201
      1021
       1201
      1021
       1201
      1021
       1201
      1021
       1201
      1021
       1201
      1021
       1201
      1021
       1201
      1021
       1201
      1021
       1201
      1021
       1201
      1021
       1201
      1021
       1201
      1021
       1201
      1021
       1201
      1021
       1201
      1021
       1201
      1021
       1221
        12111
       1222221
       1221221
       1222221
       1222221
        11111


