R 500 600
F 255,		228,196

NO ./textures/bluestone.xpm

SO		textures/wood.xpm
C 0,150   , 200
EA./textures/eagle.xpm
WE./textures/wall_4.xpm
S	./textures/sprite_1.xpm
1
1111

1111111111111111111111111111111111
10000000001100000000000000000000001
10110000011100000S00000001000111111
10010000000000000000000010001  1
10110000011100000000000010001
10000000001100000111011110001
11110111111111011100001010001
1111111111111111111111111111111111




