


R 601 601
F 255,204,0196

NO ./textures/bluestone.xpm
SO		textures/wood.xpm
C 0,150   , 	200
EA./textures/eagle.xpm
WE./textures/wall_4.xpm
S	./textures/sprite_1.xpm


1

11111111111111111111
10000000000000000001
100000000000000000001
100002222222222220001
100002222222222222221
100000000000222222N21   111
100000000000000002221   101
11111111111111111111    101
                        111
11111111111111111111
100000000000000000001
100000000000000000001
100000000000000000001
100000000000000000001
100000000000000000001
100000000000000000001
11111111111111111111