R 800	-600
F 255,228,196


NO ./textures/bluestone.xpm
SO		textures/wood.xpm
C 0,150   , 200
EA./textures/eagle.xpm
WE./textures/wall_4.xpm
S	./textures/sprite_1.xpm

1

11111111111111111111
100000000000000000001
100000000000000000001
100000000000000000001
100000000000000000001
100000000000000000S01   111
100000000000000000001   101
11111111111111111111    101
                        111
11111111111111111111
100000000000000000001
100000000000000000001
100000000000000000001
100000000000000000001
100000000000000000001
100000000000000000001
11111111111111111111