


R 600 600

F 100,200,33
NO./textures/bluestone.png
SO./textures/fred.png
EA./textures/eagle.png
WE./textures/wall_4.png
S./textures/sprite_1.png

C 255,255,56

11111111111111111111111111111
10000000001100000000000000001
10110000011100000000000010001
10010000000000000000000010001
10110000011100000000000010001
10000000001100000111011110001
11110111111111011100000010001
11110111111111011101010010001
11000000110101011100000010001
10000000000000001100000010001
10000000000000001102010020001
11000000110101000000000000001
11110111110101222222202000001
1000000000110002222220001001
10000000000000002222200001001
10000000001000010000000001001
10000000001101000000N00000001
10000000000100000001010000001
11111111111111111111111111111