R 500 600
F 255,		228,196

NO ./textures/bluestone.xpm

SO		textures/wood.xpm
C 0,150   , 200
EA./textures/eagle.xpm
WE./textures/wall_4.xpm
S	./textures/sprite_1.xpm



1

1111111111111111111111111111111111
10000000001100000000000000000000001
1011000001110000000000001000111111
10010000000000000000000010001
10110000011100000000000010001
10000000001100000111011110001
11110111111111011100000010001
1111111111111111111111111111111111

11111111111111111111111111111111
11110111111111011101010010001
11000000110101011100000010001
1000000000000000110000N010001
10000000000000001102010020001
11000000110101000000000000001
11110111110101222222202000001
1000000000110002222220001001
10000000000000002222200001001
10000000001000010000200001001
10000000001101000000000000001
10000000000100000001010000001
11111111111111111111111111111