R500 601
F 255,		228,196

NO ./textures/bluestone.xpm

SO		textures/wood.xpm
C 0,150   , 200
EA./textures/eagle.xpm
WE./textures/wall_4.xpm
S	./textures/sprite_3.xpm


11111111111111111111111111111
10000000001100000000000000001
10110001011100022220000010001
1001000000000002W220000010001
10110200011100022220000010001
10200000001100000111011110001
11112111111111011100000010001
11110111111111011101010010001
11000000110101011100000010001
10002000000000001100000010001
10000000000000001101010010001
11000000110101011111011110001
11110111111101011111011110001
11111111111111111111111111111

